X|010000000000000000000000000000000000000000000000000000|000000000000000000000000000000000000000000000000000000000000000000000000|1|4
Y|000000000000000000000000000000010000000000000000000000|000000000000000000000000000000000000000000000000000000000000000000000000|31|25
Z|000000010000000000000000000000000000000000000000000000|000000000000000000000000000000000000000000000000000000000000000000000000|7|3
W|000000000000000000001000000000000000000000000000000000|000000000000000000000000000000000000000000000000000000000000000000000000|20|26
W|000000000000000000001010000000000000000000000000000000|000000000000000000000000000000001000000000000000000000000000000000000000|22|28
Z|000000010000000000000000000000000000000000000001000000|000000100000000000000000000000000000000000000000000000000000000000000000|47|51
Y|001000000000000000000000000000010000000000000000000000|000000000000000000000000000000000000010000000000000000000000000000000000|2|6
X|010000000000000000000100000000000000000000000000000000|001000000000000000000000000000000000000000000000000000000000000000000000|21|16
W|000000000000000000001010000000000000000000000000000000|000000000000000000000000000000001010000000000000000000000000000000000000|22|17
W|000000000000000000001010000000000000000000000000000000|000000000000000000000000010000001010000000000000000000000000000000000000|32|26
Z|000000010000000000000000000000000000000000000001000000|000000100000000000000000000000000000000000000000000000000000000000100000|11|7
X|010000000000000000000100000000000000000000000000000000|001000000000000000000001000000000000000000000000000000000000000000000000|11|16
W|000000000000000000001010000000000000000000000000000000|000000000000000000000000010000001010001000000000000000000000000000000000|22|16
Y|001000000000000000000000000000010000000000000000000000|000001000000000000000000000000000000010000000000000000000000000000000000|31|36
W|000000000000000000001010000000000000000000000000000000|000000000000000000000000110000001010001000000000000000000000000000000000|28|34
Y|001000000000000000000000000000010000000000000000000000|000001000000000000000000000000000000010000000010000000000000000000000000|6|10
Y|001000000000000000000000000000010000000000000000000000|000001000100000000000000000000000000010000000010000000000000000000000000|25|19
Y|001000000000000000000000000000010000000000000000000000|000001000100000000000000000000100000010000000010000000000000000000000000|10|14
W|000000000000000000001010000000000000000000000000000000|000000000000000000000000110000001010001001000000000000000000000000000000|23|17
X|010000000000000000000100000000000000000000000000000000|001000000000000000100001000000000000000000000000000000000000000000000000|4|8
Y|001000000000000000000000000000010000000000000000000000|000011000100000010000000000000110000010000000010000000000000000000000000|24|19
Y|001000000000000000000000000000010000000000000000000000|000011000100000010000000000001110000010000000010000000000000000000000000|24|18
W|000000000000000000001010000000000000000000000000000000|000000000000000000000000111000001010001001000000000000000000000000000000|15|20
Y|001000000000000000000000000000010000000000000000000000|000011000100000010000000000011110000010000000010000000000000000000000000|18|23
Y|001000000000000000000000000000010000000000000000000000|000011000100000010000000000111110000010000000010000000000000000000000000|41|36
Y|001000000000000000000000000000010000000000000000000000|000011000100000010000000000111110000010000000010000010000000000000000000|41|46
W|000000000000000000001010000000000000000000000000000000|000000000000000000000010111000001010001001000000000000000000000000000000|17|12
W|000000000000000000001010000000000000000000000000000000|000000000000000000010010111000001010001001000000000000000000000000000000|28|33
W|000000000000000000001010000000000000000000000000000000|000000000000000000010010111000001010001011000000000000000000000000000000|27|33
Y|001000000000000000000000000000010000000000000000000000|000011000100000010000000000111110000010000000010000010000000100000000000|5|9
Y|001000000000000000000000000000010000000000000000000000|000011001100000010000000000111110000010000000010000010000000100000000000|31|37
X|010000000000000000000100000000000000000000000000000000|001000010000000000100001000000000000000000000000000000000000000000000000|1|5
X|010000000000000000000100000000000000000000000000000000|001100010000000000100001000000000000000000000000000000000000000000000000|4|0
W|000000000000000000001010000000000000000000000000000000|000000000000000000010010111000001010001111000000000000000000000000000000|29|23
W|000000000000000000001010000000000000000000000000000000|000000000000000000010010111000001011001111000000000000000000000000000000|29|34
X|010000000000000000000100000000000000000000000000000000|011100010000000000100001000000000000000000000000000000000000000000000000|8|13
W|000000000000000000001010000000000000000000000000000000|000000000000000000010010111000001011001111100000000000000000000000000000|32|37
Z|000000010000000000000000000000000000000000000001000000|100000100011000000000000000000000000000000000000000000000000000000100000|12|8
W|000000000000000000001010000000000000000000000000000000|000000000000000000010010111000001011001111100000100000000000000000000000|39|34
X|010000000000000000000100000000000000000000000000000000|011100010000010000100001000000000000000000000000000000000000000000000000|13|9
Z|000000010000000000000000000000000000000000000001000000|100000100011100000000000000000000000000000000000000000000000000000100000|43|47
X|010000000000000000000100000000000000000000000000000000|011100010000011000100001000000000000000000000000000000000000000000000000|18|13
Z|000000010000000000000000000000000000000000000001000000|100000100011100000000000000000000000000000000000000000000000001000100000|39|43
X|010000000000000000000100000000000000000000000000000000|011100010000011000101001000000000000000000000000000000000000000000000000|21|27
X|010000000000000000000100000000000000000000000000000000|011100010000011000101001000000000100000000000000000000000000000000000000|9|14
X|010000000000000000000100000000000000000000000000000000|011100010000011100101001000000000100000000000000000000000000000000000000|14|19
Z|000000010000000000000000000000000000000000000001000000|100000100011100000000000000000000000000000000000000000010000001000100000|48|51
Z|000000010000000000000000000000000000000000000001000000|100000100011100000000000000000000000000000000000000000010000001000110000|44|39
Z|000000010000000000000000000000000000000000000001000000|100000100011100000000000000000000000000000000000000000011000001000110000|48|44
