X|010000000000000000000000000000000000000000000000000000|000000000000000000000000000000000000000000000000000000000000000000000000|1|5
Y|000000000000000000000000000000001000000000000000000000|000000000000000000000000000000000000000000000000000000000000000000000000|32|37
Z|000000000000000000000001000000000000000000000000000000|000000000000000000000000000000000000000000000000000000000000000000000000|23|29
W|001000000000000000000000000000000000000000000000000000|000000000000000000000000000000000000000000000000000000000000000000000000|2|6
W|001000000000000000001000000000000000000000000000000000|000001000000000000000000000000000000000000000000000000000000000000000000|20|26
Z|000000000000000000000001000000000000000000000000001000|000000000000000000000000000000000001000000000000000000000000000000000000|50|53
Y|000000000000000000000000000000001000000000000100000000|000000000000000000000000000000000000000000000000100000000000000000000000|45|41
X|010100000000000000000000000000000000000000000000000000|000100000000000000000000000000000000000000000000000000000000000000000000|3|7
Y|000000000000000000000000000000001000000000000100000000|000000000000000000000000000000000000000000000000100000000001000000000000|49|45
Y|000000000000000000000000000000001000000000000100000000|000000000000000000000000000000000000000000000000100000000001000010000000|45|40
W|001000000000000000001000000000000000000000000000000000|000001000000000000000000000000001000000000000000000000000000000000000000|10|6
W|001000000000000000001000000000000000000000000000000000|000011000100000001000000000000001000000000000000000000000000000000000000|5|9
Z|000000000000000000000001000000000000000000000000001000|000000000000000000000000000000000001000000000000000000000000000000000001|53|49
Z|000000000000000000000001000000000000000000000000001000|000000000000000000000000000000000001000000000000000000000000000000000011|23|18
Z|000000000000000000000001000000000000000000000000001000|000000000000000000000000000100000001000000000000000000000000000000000011|34|29
Y|000000000000000000000000000000001000000000000100000000|000000000000000000000000000000000000000000000000100000000011000010000000|37|42
Y|000000000000000000000000000000001000000000000100000000|000000000000000000000000000000000000000000000000100001000011000010000000|41|46
W|001000000000000000001000000000000000000000000000000000|000011001100000001000000000000001000000000000000000000000000000000000000|14|9
W|001000000000000000001000000000000000000000000000000000|000011001100000101000000000000001000000000000000000000000000000000000000|25|20
W|001000000000000000001000000000000000000000000000000000|000011001100000101000000000000011000000000000000000000000000000000000000|15|20
Z|000000000000000000000001000000000000000000000000001000|000000000000000000000000000100000001000000100000000000000000000000000011|28|34
Y|000000000000000000000000000000001000000000000100000000|000000000000000000000000000000000000000000000000100001000011100010000000|46|42
Y|000000000000000000000000000000001000000000000100000000|000000000000000000000000000000000000000000000000100001000011110010000000|40|35
Y|000000000000000000000000000000001000000000000100000000|000000000000000000000000000000000000000000000000100101000011110010000000|32|26
W|000000000000000000000000000000000000100000000000000000|000000000000000000000000000000000000000000000000000000000000000000000000|36|41
X|000000000000000000010000000000000000000000000000000000|000000000000000000000000000000000000000000000000000000000000000000000000|19|25
Y|000000000001000000000000000000000000000000000000000000|000000000000000000000000000000000000000000000000000000000000000000000000|11|16
Z|000000000000000100000000000000000000000000000000000000|000000000000000000000000000000000000000000000000000000000000000000000000|15|10
Z|000000000000000100000000000000000100000000000000000000|000000000000000001000000000000000000000000000000000000000000000000000000|33|28
Y|000000000101000000000000000000000000000000000000000000|000000000000000000100000000000000000000000000000000000000000000000000000|9|13
X|000000000000000000010000000000000000000000000000010000|000000000000000000000000000000100000000000000000000000000000000000000000|49|45
W|000000000000000000000000000000000000100010000000000000|000000000000000000000000000000000000000000000000000010000000000000000000|40|35
Y|000000000101000000000000000000000000000000000000000000|000000000000001000100000000000000000000000000000000000000000000000000000|11|7
Y|000000000101000000000000000000000000000000000000000000|000000000010001000100000000000000000000000000000000000000000000000000000|14|9
Y|000000000101000000000000000000000000000000000000000000|000000000010001100100000000000000000000000000000000000000000000000000000|14|10
Y|000000000101000000000000000000000000000000000000000000|000000000010001110100000000000000000000000000000000000000000000000000000|6|10
Y|000000000101000000000000000000000000000000000000000000|000000000110001110100000000000000000000000000000000000000000000000000000|16|22
W|000000000000000000000000000000000000100010000000000000|000000000000000000000000000000000000000000000000000110000000000000000000|41|45
