4|25|111|1
1|27|110|1
2|26|110|1
3|28|111|1
4|26|110|1
1|25|111|1
2|27|110|1
3|24|111|1
3|26|110|2
4|27|110|1
1|24|111|1
2|22|111|1
2|27|110|1
3|23|111|1
4|26|110|1
1|25|111|1
2|27|110|1
3|26|110|1
4|25|111|1
1|23|111|1
4|27|110|1
1|26|110|1
2|23|111|1
3|24|111|1
W|19|111|2
